**********---+*
*+---+--+****|*
*|***|**+-+*-+*
*|***|****|**|*
*+-+*|** *+--+|
***+++ * ****|*
*+-+*+** *-+++*
*!***+** **++**
*!*--+-* #*++**
*!*******|*+++*
***+---*++*+*+*
***|**+-+**|*|*
+--+-**-+-*|*|*
|*******|**++++
+------*+--++++
